11111111111111111111111111111
13333333333330133333333333301
13000030000030130000030000301
14011130111130130111130111401
13011130111130130111130111301
13333333333333333333333333301
13000030030000000030030000301
13011130130111111130130111301
13333330133330133330133333301
10000030100000100000130000001
11111130111100100111130111111
11111130100000000000130111111
11111130100000000000130111111
11111130100110001100130111111
20000030000100000100030000002
20000030000100000100030000002
11111130100111111100130111111
11111130100000000000130111111
11111130100000000000130111111
11111130100111111100130111111
13333333333330133333333333301
13000030000030130000030000301
13011130111130130111130111301
14330133333330033333330133401
10030130030000000030030130001
11130130130111111130130130111
13333330133330133330133333301
13000000100030130000100000301
13011111111130130111111111301
13333333333333333333333333301
10000000000000000000000000001
11111111111111111111111111111


