11111111111111111111111111111
10000000000000100000000000001
10000000000000100000000000001
10011100111100100111100111001
10011100111100100111100111001
10000000000000000000000000001
10000000000000000000000000001
10011100100111111100100111001
10000000100000100000100000001
10000000100000100000100000001
11111100111100100111100111111
11111100100000000000100111111
11111100100000000000100111111
11111100100111111100100111111
10000000000111111100000000001
10000000000111111100000000001
11111100100111111100100111111
11111100100000000000100111111
11111100100000000000100111111
11111100100111111100100111111
10000000000000000000000000001
10000000000000000000000000001
10000000000000000000000000001
10000000000000000000000000001
10000000000000000000000000001
10000000000000000000000000001
10000000000000000000000000001
10000000000000000000000000001
10000000000000000000000000001
10000000000000000000000000001
10000000000000000000000000001
11111111111111111111111111111


